exstinguere exstinguo exstinxi exstinctum	auslöschen, vernichten
tabula	Aufzeichnung, Gemälde, Tafel
convertere converto converti conversum	verändern, umwenden, wenden
cursus cursus m	Lauf
comperire comperio comperi compertum	genau erfahren, erfahren
fatum	Götterspruch, Schicksal
gerere gero gessi gestum	ausführen, führen, tragen
cedere cedo cessi cessum	gehen, nachgeben, weichen
natio nationis f	Volk, Volksstamm
quidam quaedam quiddam	ein gewisser, irgendeiner, einige
spoliare spolio (+abl)	berauben, plündern
ignotus a um	unbekannt
nomen nominis n	Name
tacere taceo	schweigen, verschweigen
terra	Erde, Land
desinere desino desii desitum	aufhören
accendere accendo accendi accensum	anfeuern, anzünden
vindicare vindico	beanspruchen, bestrafen
fieri fio factus sum	gemacht werden, geschehen, werden
certe, certo	gewiss, sicherlich
ne...quidam	nicht...einmal
aetas aetatis f	Lebensalter, Zeitalter, Zeit
at	aber, dagegen, jedoch
nimius a um	übermässig, zu gross
praecipere praecipio praecepi praeceptum	belehren, lehren, vorschreiben
ego	ich
propinquus a um	nahe, Verwandter
reddere reddo reddidi redditum	etwas zukommen lassen, zurückgeben
ventus	Wind
postremus a um	der letzte
aer aeris m	Luft
tristis e	traurig, unfreundlich
demittere demitto demisi demissum	hinabschicken, sinken lassen
cognoscere cognosco cognovi cognitum	erkennen, kennen lernen
vultus vultus m	Gesicht, Gesichtsausdruck
exspectare exspecto	warten, erwarten
retinere retineo	behalten, festhalten, zurückhalten
calamitas calamitatis f	Schaden, Unglück
maritus	Ehemann
accipere accipio accepi acceptum	erhalten, erfahren
pro (+abl)	vor, an Stelle von, für, entsprechend
itaque	deshalb
bellum	Krieg
imitari imitor imitatus sum	nachahmen
arbor arboris f	Baum
