valere valeo	Einfluss haben, gesund sein, stark sein
ars artis f	Eigenschaft, Fertigkeit, Kunst
aio (3.Sg ait, 3.Pl aiunt)	behaupte ich, behauptete ich, sage ich, sagte ich
ducere duco duxi ductum	führen, ziehen
huc	hierher
voluptas voluptatis f	Lust, Vergnügen
subducere subduco subduxi subductum	hinaufziehen, wegnehmen
gratia	Ansehen, Beliebtheit, Dank, Gefälligkeit
castra castrorum	Lager
opus operis n	Arbeit, Werk
constare (ex +abl)	bestehen aus
egregius a um	ausgezeichnet, hervorragend
simulacrum	Bild, Bildnis, Nachbildung, Schatten
tantum	nur
convocare convoco	versammeln
regio regionis f	Gebiet, Gegend, Richtung
vertere verto verti versum	drehen, wenden
currus currus m	Wagen
domesticus a um	privat, zum Haus gehörig, einheimisch
-ne (im dir fragesatz)	(unübersetzt)
pars partis f	Teil, Seite, Richtung
incipere incipio coepi (incepi) inceptum	anfangen, beginnen
sine (+abl)	ohne
interrogare interrogo	fragen
paulo	um ein wenig, ein wenig
liberare libero	befreien, freilassen
uxor uxoris f	Ehefrau
mater matris f	Mutter
domus domus f	Haus
equus	Pferd
mille (pl milia)	tausend
acer is e	energisch, heftig, scharf
vereri vereor veritus sum	fürchten, sich scheuen, verehren
exilium	Exil, Verbannung
procedere procedo processi	vorwärtsgehen, gehen, vorrücken
amplus a um	bedeutend, gross, weit
ignarus a um (+gen)	ohne Kenntnis, unwissend
accusare accuso	anklagen, beschuldigen
plus pluris	mehr
sinister a um	links, trügerisch, falsch
cupidus a um (+gen)	begierig, gierig nach
vita	Leben, Lebensweise
incendere incendo incendi incesum	in Brand stecken
servare servo (+abl)	bewahren, retten vor, beobachten
referre refero rettuli relatum	zurückbringen, bringen, berichten
