δίδωμι	1. pers. sg. pres. ind. act.	δίδωμι ‘geben’
δίδως	2. pers. sg. pres. ind. act.	δίδωμι ‘geben’
δίδωσι(ν)	3. pers. sg. pres. ind. act.	δίδωμι ‘geben’
δίδομεν	1. pers. pl. pres. ind. act.	δίδωμι ‘geben’
δίδοτε	2. pers. pl. pres. ind. act., 2. pers. pl. pres. imp. act.	δίδωμι ‘geben’
διδόασιν	3. pers. pl. pres. ind. act.	δίδωμι ‘geben’
διδῶ	1. pers. sg. pres. subj. act.	δίδωμι ‘geben’
διδῷς	2. pers. sg. pres. subj. act.	δίδωμι ‘geben’
διδῷ	3. pers. sg. pres. subj. act., 2. pers. sg. pres. subj. med-pass.	δίδωμι ‘geben’
διδῶμεν	1. pers. pl. pres. subj. act.	δίδωμι ‘geben’
διδῶτε	2. pers. pl. pres. subj. act.	δίδωμι ‘geben’
διδῶσι(ν)	3. pers. pl. pres. subj. act.	δίδωμι ‘geben’
διδοίην	1. pers. sg. pres. opt. act.	δίδωμι ‘geben’
διδοίης	2. pers. sg. pres. opt. act.	δίδωμι ‘geben’
διδοίη	3. pers. sg. pres. opt. act.	δίδωμι ‘geben’
διδοῖμεν	1. pers. pl. pres. opt. act.	δίδωμι ‘geben’
διδοῖτε	2. pers. pl. pres. opt. act.	δίδωμι ‘geben’
διδοῖεν	3. pers. pl. pres. opt. act.	δίδωμι ‘geben’
δίδου	2. pers. sg. pres. imp. act.	δίδωμι ‘geben’
διδόναι	inf. pres. act.	δίδωμι ‘geben’
διδούς	part. pres. act. nom. sg. m.	δίδωμι ‘geben’
διδόντος	part. pres. act. gen. sg. m., part. pres. act. gen. sg. n.	δίδωμι ‘geben’
διδοῦσα	part. pres. act. nom. sg. f.	δίδωμι ‘geben’
διδούσης	part. pres. act. gen. sg. f.	δίδωμι ‘geben’
διδόν	part. pres. act. nom. sg. n., part. pres. act. acc. sg. n.	δίδωμι ‘geben’
δίδομαι	1. pers. sg. pres. ind. med-pass.	δίδωμι ‘geben’
δίδοσαι	2. pers. sg. pres. ind. med-pass.	δίδωμι ‘geben’
διδῶμαι	1. pers. sg. pres. subj. med-pass.	δίδωμι ‘geben’
διδῶται	3. pers. sg. pres. subj. med-pass.	δίδωμι ‘geben’
διδοίμην	1. pers. sg. pres. opt. med-pass.	δίδωμι ‘geben’
διδοῖο	2. pers. sg. pres. opt. med-pass.	δίδωμι ‘geben’
διδοῖτο	3. pers. sg. pres. opt. med-pass.	δίδωμι ‘geben’
δίδοσο	2. pers. sg. pres. imp. med-pass.	δίδωμι ‘geben’
δίδοσθε	2. pers. pl. pres. imp. med-pass., 2. pers. pl. pres. ind. med-pass.	δίδωμι ‘geben’
δίδοσθαι	inf. pres. med-pass.	δίδωμι ‘geben’
διδόμενος	part. pres. med-pass. nom. sg. m.	δίδωμι ‘geben’
ἔδωκα	1. pers. sg. aor. ind. act.	δίδωμι ‘geben’
ἔδωκας	2. pers. sg. aor. ind. act.	δίδωμι ‘geben’
ἔδωκε(ν)	3. pers. sg. aor. ind. act.	δίδωμι ‘geben’
ἔδομεν	1. pers. pl. aor. ind. act.	δίδωμι ‘geben’
ἔδοτε	2. pers. pl. aor. ind. act.	δίδωμι ‘geben’
ἔδοσαν	3. pers. pl. aor. ind. act.	δίδωμι ‘geben’
δῶ	1. pers. sg. aor. subj. act.	δίδωμι ‘geben’
δῷς	2. pers. sg. aor. subj. act.	δίδωμι ‘geben’
δῷ	3. pers. sg. aor. subj. act., 2. pers. sg. aor. subj. med.	δίδωμι ‘geben’
δῶμεν	1. pers. pl. aor. subj. act.	δίδωμι ‘geben’
δῶτε	2. pers. pl. aor. subj. act.	δίδωμι ‘geben’
δῶσι(ν)	3. pers. pl. aor. subj. act.	δίδωμι ‘geben’
δοίην	1. pers. sg. aor. opt. act.	δίδωμι ‘geben’
δοίης	2. pers. sg. aor. opt. act.	δίδωμι ‘geben’
δοίη	3. pers. sg. aor. opt. act.	δίδωμι ‘geben’
δοῖμεν	1. pers. pl. aor. opt. act.	δίδωμι ‘geben’
δοῖτε	2. pers. pl. aor. opt. act.	δίδωμι ‘geben’
δοῖεν	3. pers. pl. aor. opt. act.	δίδωμι ‘geben’
δός	2. pers. sg. aor. imp. act.	δίδωμι ‘geben’
δότε	2. pers. pl. aor. imp. act.	δίδωμι ‘geben’
δοῦναι	inf. aor. act.	δίδωμι ‘geben’
δούς	part. aor. act. nom. sg. m.	δίδωμι ‘geben’
δόντος	part. aor. act. gen. sg. m., part. aor. act. gen. sg. n.	δίδωμι ‘geben’
δοῦσα	part. aor. act. nom. sg. f.	δίδωμι ‘geben’
δούσης	part. aor. act. gen. sg. f.	δίδωμι ‘geben’
δόν	part. aor. act. nom. sg. n.	δίδωμι ‘geben’
ἐδόμην	1. pers. sg. aor. ind. med.	δίδωμι ‘geben’
ἔδου	2. pers. sg. aor. ind. med.	δίδωμι ‘geben’
ἔδοτο	3. pers. sg. aor. ind. med.	δίδωμι ‘geben’
ἐδόμεθα	1. pers. pl. aor. ind. med.	δίδωμι ‘geben’
ἔδοσθε	2. pers. pl. aor. ind. med.	δίδωμι ‘geben’
ἔδοντο	3. pers. pl. aor. ind. med.	δίδωμι ‘geben’
δῶμαι	1. pers. sg. aor. subj. med.	δίδωμι ‘geben’
δῶται	3. pers. sg. aor. subj. med.	δίδωμι ‘geben’
δώμεθα	1. pers. pl. aor. subj. med.	δίδωμι ‘geben’
δῶσθε	2. pers. pl. aor. subj. med.	δίδωμι ‘geben’
δῶνται	3. pers. pl. aor. subj. med.	δίδωμι ‘geben’
δοίμην	1. pers. sg. aor. opt. med.	δίδωμι ‘geben’
δοῖο	2. pers. sg. aor. opt. med.	δίδωμι ‘geben’
δοῖτο	3. pers. sg. aor. opt. med.	δίδωμι ‘geben’
δοίμεθα	1. pers. pl. aor. opt. med.	δίδωμι ‘geben’
δοῖσθε	2. pers. pl. aor. opt. med.	δίδωμι ‘geben’
δοῖντο	3. pers. pl. aor. opt. med.	δίδωμι ‘geben’
δοῦ	2. pers. sg. aor. imp. med.	δίδωμι ‘geben’
δόσθε	2. pers. pl. aor. imp. med.	δίδωμι ‘geben’
δόσθαι	inf. aor. med.	δίδωμι ‘geben’
δόμενος	part. aor. med. nom. sg. m.	δίδωμι ‘geben’
δώσω	1. pers. sg. fut. ind. act.	δίδωμι ‘geben’
ἐδόθην	1. pers. sg. aor. ind. pass.	δίδωμι ‘geben’




