σύν	mit	
ξύν	mit	attische Variante
σὺν τοῖς θεοῖς	mit den Göttern	
εἰμί	ich bin	enklit.
σύνειμι	mit jmdm verkehren	
σύνειμι θεοῖς	ich verkehre mit Göttern	
ἀγαθός, ή, όν	gut, tüchtig	
τὸ ἔργον	das Werk, die Arbeit	
καλός, ή, όν	schön, gut	
θεῖος, α, ον	göttlich	
ἀνθρώπειος, α, ον	menschlich	
χωρίς	getrennt von, ohne	
χωρὶς ἐμοῦ	ohne mich	
τιμάω	einschätzen, taxieren, schätzen, ehren	
καί ... καί	sowohl ... als auch	
παρά	bei, neben	
παρὰ θεοῖς καὶ ἀνθρώποις	bei Göttern und Menschen	
ἡ εἰρήνη	der Friede	
ὁ πόνος	die Arbeit, die Mühe, die Strapaze	
βέβαιος, α, ον	feststehend, fest, zuverlässig	
ὁ πόλεμος	der Krieg	
ὁ σύμμαχος	der Bundesgenosse	
ἡ σύμμαχος	die Bundesgenossin	
ἄριστος, η, ον	der tüchtigste, der beste, der tapferste	
νέος, α, ον	jung, neu	
οἱ νέοι	die jungen Leute	
πρεσβύτερος, α, ον	älter	
ὁ ἔπαινος	das Lob	
ἡ τιμή	der Preis, der Wert, der Schadenersatz, die Strafe, die Ehre, das Amt	
διά	wegen	
διὰ τὸν πόλεμον	wegen des Krieges	
φίλος, η, ον	lieb, befreundet	
ὁ φίλος	der Freund	
μετά	nach	
ὁ βίος	das Leben	
ἡ τελευτή	das Ende	
μετά τὴν τελευτήν	nach dem Ende	
μετά	mit	
μετὰ τῶν φίλων	mit den Freunden	
ἄτιμος, ον	verachtet, geächtet	
ἡ μνήμη	das Gedächtnis, die Erinnerung	
κεῖμαι	liegen	
ἀεί	immer	
αἰεί	immer	
ὁ χρόνος	die Zeit	
ὑμνέω	besingen, preisen	
σοφός, ή, όν	geschickt, klug, intelligent, weise	
ὁ ἀγαθὸς ἄνθρωπος	der gute Mensch	R22a
ὁ ἄνθρωπος ὁ ἀγαθός	der gute Mensch	R22b
ἔργον καλόν	ein schönes Werk, ein gutes Werk	R23a
καλὸν ἔργον	ein schönes Werk, ein gutes Werk	R23b
Τοῖς ἐπαίνοις χαίρουσιν.	Sie freuen sich über die anerkennenden Worte., Sie freuen sich über das Lob.	R24: dativus causae
ὁ ἀεὶ χρόνος	die immerwährende Zeit, die Ewigkeit	R25
τὸν ἀεὶ χρόνον	über die ganze Zeit hin, in alle Ewigkeit	R26: Akk. der räumlichen oder zeitlichen Ausdehnung
