σκέπτομαι	betrachten, überlegen, prüfen	
ποῖος, α, ον;	was für ein?	
δεῖ	es ist nötig, es ist erforderlich	
ὁ φύλαξ	der Wächter	
οἰκεῖος, α, ον	verwandt, eigen, eigentümlich	
χαλεπός, ή, όν	schwierig, unangenehm, lästig	
ἄλλως	auf andere Weise	
δύναμαι	können, imstand sein	
παραβάλλω	nebeneinanderstellen, vergleichen	
ὁ κύων	der Hund	
γενναῖος, α, ον	adlig, edel, tüchtig, echt, unverfälscht	
ἀντίος, α, ον	entgegen	
ἐναντίος, α, ον	entgegen	
ὁ ἀντίος	der Gegner	
ὁ ἐναντίος	der Gegner	
τοὐναντίον	das Gegenteil, im Gegenteil	R34: Krasis
πάνυ	gänzlich, völlig	
πάνυ μὲν οὖν	durchaus, allerdings	
ποῦ;	wo?	
ποῦ γῆς;	wo auf der Erde?	Gen. part.
γελοῖος, α, ον	lächerlich, komisch	
γε	wenigstens	enklit.
δέομαι	etw brauchen, etw nötig haben, jmdn bitten	mit Gen.
δέομαι φύλακος	ich bedarf eines Wächters, ich brauche einen Wächter	
σώφρων, ον	besonnen, massvoll, vernünftig	
ἄφρων, ον	unbesonnen, unverständig	
ὁ νόμος	der Brauch, die Sitte, das Gesetz	
ἡ ἡδονή	die Freude, die Lust	
ὁ ῥήτωρ	der Redner, der Rhetor	
ὁ ῞Ελλην	der Grieche, der Hellene	
Γελοῖον γὰρ τόν γε φύλακα φύλακος δεῖσθαι.	Lächerlich## wenn der Wächter einen Wächter braucht.	R35
