ἀπορέω	ratlos sein, Mangel haben	
ἀπορέω ἀνθρώπων	ich habe Mangel an Leuten	
βάρβαρος	nichtgriechisch	
ὁ βάρβαρος	der Barbar	eigtl.: 'unverständlich sprechend'; urspr. ohne abwertenden Unterton
διὰ τοῦτο	deshalb	
προσλαμβάνω	mit anfassen, dazunehmen, zu sich nehmen	
ἡ ἐλευθερία	die Freiheit	
κτάομαι	erwerben	Perf.: besitzen
εὐδαιμονίζω	jmdn für glücklich halten	
αἱρέομαι	wählen	
ἀντί	anstatt	
ἀντὶ τοῦ πλούτου	anstatt des Reichtums	
τὸ πλῆθος	die Menge	
ἔπειμι	darauf sein, dabei sein	
ἀνέχομαι	aushalten, ertragen	
αἰσχύνομαι	sich schämen, sich scheuen	
αἰσχύνομαι ὑμᾶς	ich schäme mich vor euch	
δοκῶ μοι	ich meine## dass ich...	ich komme mir vor
αἰσχυνεῖσθαί μοι δοκῶ	ich glaube## mich schämen zu müssen	
οἴκαδε	nach Hause	
οἴκοι	zu Hause	
ζηλόω	nacheifern, beneiden, bewundern	
Φροντίζομεν, ὅπως ἄξιοι ἐσόμεθα τῆς ἐλευθερίας.	Wir bemühen uns darum## dass wir in Zukunft der Freiheit würdig sind.	R127a: Verbum des Sorgens und Strebens
῾Υμᾶς διδάξω, ὅπως εἰδῆτε...	Ich werde euch belehren## damit ihr wisst...	R127b: finale Konjunktion
῎Αξιοι ἔσεσθε τ῀ςη ἐλευθερίας, ἧς κέκτησθε.	Ihr werdet der Freiheit würdig sein## die ihr besitzt.	R128: attractio relativi
