ὁ ποιμήν	der Hirte	
ἡ ἡμέρα	der Tag	
τὸ ποτόν	der Trank	
ποτέ ... ποτέ	bald ... bald	
ὁ λύκος	der Wolf	
τὸ δέρμα	die Haut	
ὁ ταῦρος	der Stier	
πρό	vor, für	
πρὸ τῆς θύρας	vor der Tür	
πρὸ τοῦ φίλου	für den Freund	
ὁ βοῦς	das Rind	
ἡ βοῦς	die Kuh	
μάχομαι	kämpfen	
τοῖς πολεμίοις μάχεσθαι	mit den Feinden kämpfen	
φονεύω	Mörder sein, töten	
τείνω	dehnen, spannen, ausstrecken, sich erstrecken	
περιτείνω	etw umspannen	
κρύπτω	verbergen, verhehlen	
ἀποκρύπτομαι	sich verbergen	
ἡ πηγή	die Quelle	
ἡ αἶξ	die Ziege	
τὸ πρόβατον	das Kleinvieh (Schaf## Ziege)	
τηρέω	behüten, bewahren, beobachten	auf etw achten
ἐλαύνω	treiben, vertreiben, ziehen, marschieren, reiten	
κατά	von ... herab, auf ... herab, gegen	
κατὰ τοῦ ἵππου	vom Pferd herab	
κατελαύνω	hinuntertreiben	
ὁρμάω	antreiben, aufbrechen	2: eigtl. ein Heer antreiben
πρίν	bevor	
πηδάω	springen	
ἀναπηδάω	aufspringen	
ὁ ἔλεγχος	die Untersuchung, die Prüfung, die Widerlegung	
φρουρέω	Wache halten, bewachen, schützen	
σιωπάω	schweigen	
καλέω	rufen, nennen	
βοηθέω	zu Hilfe eilen, helfen	
ὁ βοηθός	der Helfer	
ἅπτομαι	anfassen, berühren	mit Gen.
ἥπτοντο τοῦ Δόρκωνος	sie fassten Dorkon	
ἱκετεύω	um Schutz flehen, jmdn anflehen	
ἡ κόρη	das Mädchen	
ταχέως	schnell	Adv.
ποιμενικός, ή, όν	hirten-	
ἡ παιδιά	das Spiel, der Spass	
πέμπω	schicken, begleiten	
ἀποπέμπω	wegschicken, entsenden	
πολύς, πολλή, πολύ	viel	
καθ᾽ ἡμέραν	täglich	R50: Hauchassimilation
ὑφ᾽ ἡμῶν	von uns	R50: Hauchassimilation
Τὸν ἔλεγχον φοβούμενος ὁ Δόρκων ἔκειτο ἐν τῇ λόχμῃ.	Da er die Entlarvung fürchtete## blieb Dorkon im Gebüsch liegen.	R51: kausal
