τὸ μέλος	das Glied (Körperteil), das Lied	
ὁ ὀφθαλμός	das Auge	
ὁ πούς	der Fuss	
κεράννυμι	mischen	
συγκεράννυμι	zusammenmischen	
τὸ σχίσμα	die Spaltung	
ἀλλήλων	einander	
πάσχω	etw erleiden, erleben	unter einer Einwirkung stehen
Τί ἔπαθες;	Was ist dir passiert?	Was hast du erlitten?
συμπάσχω	mitleiden	
δοξάζω	meinen, (NT:) rühmen	
συγχαίρω	sich mitfreuen	
ἀσθενής	kraftlos, krank	
κερδαίνω	gewinnen	
ἐκλέγω	auslesen, auswählen	
ὁ καιρός	der rechte Zeitpunkt, die günstige Gelegenheit, der Vorteil	
κατὰ καιρόν	zur rechten Zeit	
ἀσεβής	gottlos	ohne Scheu vor dem Göttlichen
τὸ σκάνδαλον	das Anstössige, das Ärgernis	
μῶρος	töricht, dumm	
μωρός	töricht, dumm	
ἡ μωρία	die Torheit, die Dummheit	
ἡ σοφία	die Geschicklichkeit, die Klugheit, die Intelligenz, die 'Weisheit'	
σαφής	deutlich, klar, gewiss	
τὸ ὅπλον	die Waffe	
ἄνω	hinauf, oben	Adv.
ἄνωθεν	von oben, von jeher, von neuem	
ἀναχωρέω	zurückweichen	
βιάζομαι	zwingen	
πολεμικός	Kriegs-, kriegerisch, kriegserfahren	zum Krieg gehörig
