ἡ ἀρχή	der Anfang, die Herrschaft, das Amt	
κατ᾽ ἀρχάς	anfangs	
δημιουργικός	Handwerks-	
ἐνδεής	bedürftig, dürftig, mangelhaft	1: von Personen; 2+3: von Sachen
οὔπω	noch nicht	
τὸ μέρος	der Teil, der Anteil	
κτίζω	besiedeln, gründen	
ἁθροίζω	sammeln, versammeln	
ὅτε	(zu der Zeit,) als, jedesmal, wenn	
ἅτε	da ja	beim Part.; objektiv begründend
δείδω	fürchten	Präsens selten
περί	um ... herum, um	
τὸ γένος	das Geschlecht, die Gattung	
ἔδεισε περὶ τῷ γένει ἡμῶν	er fürchtete um unsere Gattung	
ἀπόλλυμαι	vernichtet werden, zugrunde gehen	
῾Ερμῆς	Hermes	[Gen., Dat., Akk.]
ἡ αἰδώς	die Scheu, die Scham, die Ehrfurcht, die Achtung	[Gen., Dat., Akk.]
ὁ δεσμός	das Band, die Fessel	
νέμω	zuteilen, weiden lassen	
ἡ νόσος	die Krankheit	
διὰ τὸ πανταχῇ αὐτῶν ἀσθενέστεροι εἶναι	wegen des Umstands## dass sie in jeder Hinsicht schwächer als diese waren	R102
῞Οτε ἁθροισθεῖεν, ἠδίκουν ἀλλήλους.	Immer wenn sie sich versammelten## taten sie einander Unrecht.	R103
ἅτε δίκαιος ὤν	weil er gerecht ist, weil er gerecht war	R104
ὡς δίκαιος ὤν	da er gerecht sei, als ob er gerecht wäre	R104
Φοβεῖται, μὴ διαφθείρηται τὸ γένος ἡμῶν.	Er fürchtet## dass unsere Gattung zugrunde geht.	R105
Εφοβεῖτο, μὴ διαφθείροιτο τὸ γένος ἡμῶν.	Er fürchtete## dass unsere Gattung zugrunde geht.	R106
῾Ερμῆς ἤνεγκε αἰδὼ καὶ δίκην, ἵνα εἶεν πόλεων δεσμοί.	Hermes brachte Achtung und Recht## damit sie Bande der Städte seien.	R107
μὴ οὐ	wohl nicht	R108
οὐ μή	gewiss nicht	R108
