συννοέω	verstehen, begreifen, überlegen, durchdenken	
αὐτόθι	ebendort	
αὐτοῦ	ebendort	
ἡ ἕως	das Frührot, der Tagesanbruch	
ἕωθεν	vom Morgen an, am Morgen, früh	
ἕστηκα	ich stehe	Perfekt zu 'histamai'
προχωρέω	vorwärts gehen, verreisen	
ἀνίημι	jmdn loslassen, nachlassen	
ἡ μεσημβρία	der Mittag, der Süden	
τελευτάω	vollenden, beednigen, sterben	
ἡ ἑσπέρα	der Abend, der Westen	
θερμός	warm	
τὸ θέρος	der Sommer	
τότε	damals, dann	
ἐκφέρω	heraustragen, wegschaffen, beerdigen, zum Vorschein bringen	
μέχρι	bis, bis zu	
μέχρι τῆς ἑσπέρας	bis zum Abend	
μέχρι ἕως ἐγένετο	bis es Morgen werde	
οἴχομαι	fortgehen, fort sein	
ἄπειμι	abwesend sein, fehlen, weggehen, desertieren	
προσεύχομαι τῷ ἡλίῳ	ich bete die Sonne an	
δέδοικα	sich fürchten	
δέδια	sich fürchten	
περιίσταμαι	herumstehen, umzingeln, umschlagen (z.B. ins Gegenteil)	
ἡ εὐχή	die Bitte, das Gebet, das Gelübde	
κοιμάομαι	sich schlafen legen, schlafen	
κατακοιμάομαι	sich schlafen legen, schlafen	mit Vorsilbe
ἡ εἰκών	das Bild, das Gleichnis	
τὸ τέλος	das Ende, der Zweck, die Steuer, das Amt	
τελευτῶντες καθηῦδον	schliesslich schliefen sie	R123
ᾤχετο ἀπιών	er ging rasch weg, schnell war er weg	R123: 'weggehend war er [auch schon] weg'
