ἐκ τῶν εἰρημένων	auf Grund des Gesagten	
ὁ ποιητής	der Dichter, der Poet	
τὸ εἰκός	die Wahrscheinlichkeit	
ὁ ἱστορικός	der Historiker	
τὸ μέτρον	das Mass, das Versmass	
ἔμμετρος	metrisch, massvoll, mässig, angemessen	
ἄμετρος	masslos, unmässig, unermesslich	
τίθημι	setzen, stellen, legen, zu etwas machen	
φιλόσοφος	philosophisch	
σπουδαῖος	eilig, eifrig, ernst	
ἡ ποίησις	die Dichtung, die Poesie	
καθόλου	im ganzen, im allgemeinen	
καθ᾽ ἕκαστον	im einzelnen	
ἄττα	irgendwelche Dinge	Nom./Akk. Neutr. Plur. des Indef.pron.
ποῖα ἄττα;	Dinge welcher Art?	
στοχάζομαι	nach etw streben, etw zum Ziel nehmen	
τούτου στοχάζομαι	danach strebe ich	
ἐπιτίθημι	darauf stellen, darauf legen, etw auferlegen	
ὀνειδίζω	jmdm Vorwürfe machen, jmdn tadeln	
αἰδέομαι	Scheu empfinden, Ehrfurcht empfinden	
ὅσιος	heilig, fromm, recht	
ἀνόσιος	unheilig, gottlos, ohne rituelle Bestattung	
τὸ κέρδος	der Gewinn, der Vorteil	
ὁ μήν	der Monat	
πολιτεύομαι	sich politisch betätigen	
ἐξόν	weil / obwohl / wenn es möglich ist / war / wäre / gewesen wäre	R129a
ἐξὸν ἐν εἰρήνῃ πολιτεύεσθαι	obwohl es möglich wäre## in Frieden zu leben	R129a: absolutes Partizip
ὀλίγου δεῖν	beinahe	R129b: absoluter Infinitiv; eigtl.: 'wenig gefehlt'
