πότερος, α, ον;	welcher von beiden?	
πότερον - ἤ	(ob) ... oder	
δοκεῖ μοι	es scheint mir, es scheint mir gut, ich beschliesse	mit AcI oder Infinitiv
ἡ ὑγίεια	die Gesundheit	
ὁ ἀνήρ	der Mann, der Mensch	
ἡ γυνή	die Frau	
εἴτε ... εἴτε	sei es(## dass) ... oder (dass)	
ἔγωγε	ich für mein Teil, ich wenigstens	
πως	irgendwie	enkl.
Σωκράτης	Sokrates	
ὦ Σώκρατες	Sokrates	Vokativ
οὐκέτι	nicht mehr	
μηκέτι	nicht mehr	
ὅμοιος, α, ον	gleich, ähnlich	
ἡ πόλις	die Stadt, der Staat	
εὖ	gut	
ἐπιτροπεύω	beaufsichtigen, verwalten	
ἆρα	(leitet eine Frage ein)	
δῆτα	wirklich, gewiss	
οὐκοῦν	folglich, nicht wahr?	2: bei Fragen
ἡ ἀνάγκη	der Zwang, die Notwendigkeit, die Not	
ἀνάγκη	notwendigerweise	erg. 'estin'
εἴπερ	wenn wirklich, wenn also	
μέλλω	wollen, im Begriff sein, zögern	+ Infinitiv
ὁ τρόπος	die Art und Weise, der Charakter	
ὁ πατήρ	der Vater	
ἡ μήτηρ	die Mutter	
ἡ θυγάτηρ	die Tochter	
διαφέρειν τι	sich in etw unterscheiden	R44: Akk. der Beziehung
εἰ μή	wenn nicht, ausser	R45
τῷ αὐτῷ τρόπῳ	auf dieselbe Weise	R46: dativus modi
