ἡ ἀγέλη	die Herde	
εἰς	in ... hinein, gegen	
ἐς	in ... hinein, gegen	
εἰς τὸν οὐρανόν	in den Himmel	
βαίνω	gehen	
προβαίνω	vorrücken, fortschreiten	
ἡ θύρα	die Tür, das Tor	
προβαίνω τῆς θύρας	ich gehe vor die Tür	
στρέφω	drehen, wenden, umkehren	
ἄλλος, η, ο	ein anderer	
ὁ γεωργός	der Bauer	
ἀπαλλάττω	entfernen, befreien	
πόνων ἀπαλλάττειν	von Mühen befreien	
μιμνήσκομαι	sich erinnern	
ὡς	wie, dass	
φιλέω	lieben, küssen	
βάλλω	werfen, treffen	
περιβάλλω	etw um etw herumlegen, umarmen	
ἅμα	zusammen, zugleich	
ἡ τροφή	die Nahrung, die Ernährung	
φέρω	tragen, bringen	
προσφέρω	hintragen, herbeibringen	
λυπηρός, ά, όν	betrüblich, betrübt	
διάγω	(Zeit) verbringen	
ἡ ὥρα	die Jahreszeit, die Stunde	
μένω	bleiben, warten, erwarten	
ἀναμένω	bleiben, warten, erwarten	
ὁ θάνατος	der Tod	
ἡ λύπη	das Leid, der Kummer	
παρέχω	anbieten, gewähren, überreichen	
λύπην παρέχειν	Kummer bereiten	
ὅς, ἥ, ὅ	welcher, welche, welches, der, die, das	
ἐσθίω	essen	
συνεσθίω	zusammen essen, mit jmdm essen	
ἤ	oder	
ἤ ... ἤ	entweder ... oder	
πίνω	trinken	
συμπίνω	mit jmdm trinken, zusammen trinken	
εὔχομαι	beten, wünschen	
δή	also, folglich	
ἡ νύμφη	die junge Frau, die Braut, die Nymphe	
λύω	lösen	
ἐκλύω	herauslösen, auflösen, auslösen	
φαίνω	sehen lassen, zeigen	
ἀναφαίνω	sehen lassen, zeigen	
ποτέ	irgendwann , irgendwann einmal	enklit.
