ἡ φύσις	die Natur	
αἰσχρός, ά, όν	hässlich, schändlich, niederträchtig, gemein	
αἰσχίων, ιον	hässlicher, schändlicher, niederträchtiger, gemeiner	Komparativ
αἴσχιστος, η, ον	der hässlichste, der niederträchtigste, der schändlichste, der gemeinste	Superlativ
φύσει - νόμῳ	von Natur - aufgrund blosser Übereinkunft	
οἷός τέ εἰμι	imstande sein	
οἱ πολλοί	die meisten, die Mehrzahl, die Masse	
πλεονεκτέω	mehr haben von etw, im Vorteil sein vor jmdm, mehr haben wollen, jmdn übervorteilen	mit Gen.
τοῦ ἥττονος πλεονεκτεῖν	im Vorteil sein vor dem Schwächeren, den Schwächeren übervorteilen	
χείρων, ον	geringer, minder	
δηλόω	klar machen, zeigen	
πολλαχοῦ	an vielen Stellen	
ἡ ῲδή	das Lied, die Ode	
ἐπριάμην	ich kaufte	nur im Aorist vorkommend
δωρέομαι	schenken	
τὸ κτῆμα	das Erworbene, der Besitz	
βελτίων, ον	besser	der Abstammung nach oder im moralischen Sinne
βέλτιστος, η, ον	der beste	
ὁ ἀετός	der Adler	
ἡ ἀγορά	die Versammlung, der Versammlungsplatz, der Markt	
ὑπό	unter	auf die Frage: wo?
ὑπὸ τῷ οὐρανῷ	unter dem Himmel	
τὸ πλέον τῶν ἄλλων ζητεῖν ἔχειν	das Streben## mehr als die andern zu haben	R77: Infinitiv behält seine verbale Natur
ὡς τούτου τοῦ δικαίου ὄντος φύσει	da dies das von Natur aus Gerechte sei	R78
