ὁ ἀγών	der Wettkampf, der Prozess	
ἀποκτείνω	töten	
τὸ ἔτος	das Jahr	
δέκα	zehn	
δώδεκα	zwölf	
γίγνομαι	werden, entstehen	
τιμωρέομαι	sich an jmdm rächen, jmdn bestrafen	
λέγω	sagen, reden, nennen	
ἀπαγορέυω	verbieten, untersagen, bei etw versagen, aufhören	
ὁ ἀνδροφόνος	der Mörder	
διαφέρομαι	sich entzweien, mit jmdm streiten	
ὁπόσος	wieviel, wie gross, wie gross auch immer, wieviel auch immer	
ὁπόσος ἄν	wie gross auch immer, wieviel auch immer	mit Konj.
ὁ νομοθέτης	der Gesetzgeber	
ῥίπτω	werfen	
ἡ ἀσπίς	der Schild	
καίτοι	und doch, trotzdem	
βάλλω	werfen, treffen	
ἀποβάλλω	wegwerfen	
πέντε	fünf	
-κόσιοι	-hundert	
πεντακόσιοι	500	
ἡ δραχμή	die Drachme	
ὀφείλω	schulden, sollen	
δέω	binden	
ἕνδεκα	elf	
ἡ συγγνώμη	das Verständnis, die Verzeihung	
ὑβρίζω	übermütig sein, zügellos sein, jmdn misshandeln	
καὶ ταῦτα	und zwar	
ἡ στρατηγία	das Amt des Feldherrn, die Heerführung	
στρατηγέω	Heerführer sein	
κινδυνεύω	gefährdet sein, in Gefahr geraten, in Gefahr scheinen	
κινδυνεύεις ὄλβιος εἶναι	du scheinst glücklich zu sein, möglicherweise bist du glücklich	
ἕξ	sechs	
-κοντα	-zig	
ἑξήκοντα	60	
τέθνηκα	tot sein	
ἀναιρέω	aufnehmen, aufheben, weissagen, zerstören, töten	
ὑμέτερος	euer	
ἱερός	heilig, geweiht	
τὸ ἱερόν	das Opfer, das Heiligtum	
῾Ο πατὴρ ὑπὸ τῶν τριάκοντα ἁπέθανεν.	Der Vater wurde von den dreissig Tyrannen getötet.	R112: 'Der Vater starb unter der Einwirkung der dreissig Tyrannen.'
πολλοῦ ἄξιος	viel wert	R113
πλείονος ἄξιος	mehr wert	R113
πλείστου ἄξιος	am meisten wert	R113
