μεριμνάω	besorgt sein, Sorge haben, etw besorgen	
πλεῖστος, η, ον	der/die/das meiste, am meisten	Superlativ
ἕπομαι	folgen	
συνέπομαι	zusammen folgen	
ὁ χῶρος	der Ort, der Platz	
πρός	bei, an, zusätzlich zu	
πρὸς τίσι χώροις;	an welchen Plätzen?	
ὁ τόπος	der Ort	
ὅδε, ἥδε, τόδε	dieser, diese, dieses	Demonstrativ
ὅδε ὁ ἀνήρ	dieser Mann	
οἶδα	wissen	Perfekt
τῇδε	hier, so	
ἐμός, ή, όν	mein	Possessivpronomen
πρός	von ... her	
πρὸς τοῦ ποταμοῦ	vom Fluss her	
πρὸς θεῶν	bei den Göttern	
ὁ δεσπότης	der Herr, der Herrscher, der Despot	
ἱστορέω	jmdn fragen, forschen, etw erforschen	
πλείων, πλεῖον	mehr	Komparativ
πλέων, πλέον	mehr	Komparativ
ἀπόλλυμαι	vernichtet werden, zugrunde gehen	
τοι	also, folglich, gewiss	enklit.
τοίνυν	also, folglich, gewiss	
ἦ	gewiss	kann auch Fragen einleiten
εἴσω	hinein, drinnen	
ἔσω	hinein, drinnen	
κάλλιστος, η, ον	der schönste	Superlativ
οὕτως ἔχει	so verhält es sich	
σός, σή, σόν	dein	Possessivpronomen
δίδωμι	geben	
δίδωσι	er/sie/es gibt	3. Sg. Von didomi
ἡ χρεία	das Bedürfnis, der Gebrauch, der Nutzen	
τίκτω	zeugen, gebären	
πῶς;	wie?	
ἵημι	in Bewegung setzen, senden	Konjug. L53
ἀφίημι	entsenden, freilassen	
ὁ γέρων	der alte Mann, der Greis	
οὗτος ὁ ἀνήρ	dieser Mann	R67
ὁ ἀνὴρ οὗτος	dieser Mann	R67
ὅδε ὁ ἀνήρ	dieser Mann	R67
ὁ ἀνὴρ ὅδε	dieser Mann	R67
ἐκεῖνος ὁ ἀνήρ	jener Mann	R67
ὁ ἀνὴρ ἐκεῖνος	jener Mann	R67
ἡ τῆς Χλόης φιλία	die Freundschaft der Chloe, die Freundschaft mit Chloe	R68: 1: gen. subiectivus 2: gen. obiectivus
