πλησίον	nahe	
πλησίον τοῦ οἴκου	nahe beim Haus	
βαίνω	gehen	
ἀναβαίνω	hinaufgehen, besteigen, an Bord gehen, absegeln	
τὸ δένδρον	der Baum	
ὑπόκειμαι	darunter liegen, zugrunde liegen	
ἐξέρχομαι	hinausgehen, herauskommen, (von Ereignissen:) ausgehen	
ἀπορέω	ratlos sein, Mangel haben an etw.	
κατεσθίω	aufessen, verschlingen	
ἐπανέρχομαι	zurückkehren	
γιγνώσκω	erkennen, erfahren, einsehen, kennen, wissen, beschliessen	
ἀμύνομαι	sich wehren, sich gegen jmdn verteidigen	
πόρρωθεν	aus der Ferne, seit langer Zeit, von weitem	
ἵσταμαι	sich hinstellen, (wohin) treten	
ἡ ἀσέβεια	die Gottlosigkeit, der Frevel, die Freveltat	
ὑπολείπω	verlassen, zurücklassen, übriglassen	
ὁ βωμός	der Altar	
ἀναφέρω	hinaufbringen, heraufholen, opfern	
σφοδρός	heftig	
λεπτός	dünn, fein, zart	
παλαιός	alt	
διὰ τοῦτο	deshalb	
καταπίπτω	herunterfallen, in etw verfallen, hinfallen, einfallen	
ἡ ὄψις	das Sehen, der Anblick	
ἀναγιγνώσκω	wiedererkennen, lesen	
καταγιγνώσκω	jmdn verurteilen	
ἁλίσκομαι	gefangen werden, erobert werden, überführt werden	
