cum (+konj)	als, da, weil, obgleich, während
expetere	erstreben, anstreben
otium i n	freie Zeit, Musse
otiosus a um	unbeschäftigt
cedere cedo cessi cessum	gehen, weichen
recedere	zurückweichen, sich zurückziehen
severus a um	streng, ernst
gravis e	schwer, ernst, gewichtig
familiaris e	zur Familie gehörig, eng befreundet
administrare	verwalten, verrichten
ipse ipsa ipusm (ius i)	selbst
vix	kaum
dominatus us m	Herrschaft, Alleinherrschaft
usquam	irgendwo
nusquam	nirgendwo
amittere	verlieren
studium i n	Bemühung, Studium
adulescens adulescentis m f	jugendlich, junger Mann, junge Frau
tribuere tribuo tribui tributum	zuweisen, zuteilen, widmen
tunc	dann, damals
molestia ae f	Ärger, Kummer, Last
deponere	ablegen
evertere	umstürzen, zerstören
resistere resisto restiti	sich widersetzen, stehenbleiben
satis	genug
littera ae f	Buchstabe
litterae arum	Brief, Schrift, Wissenschaften
mandare	anvertrauen, übergeben
parum	wenig, zu wenig
notus a um	bekannt
cognitio cognitionis f	Kenntnis, Kennenlernen
dignus a um (+abl)	wert, würdig
malle malo malui	lieber wollen
coepisse coepi coeptum	angefangen haben
status us m	Zustand
cupidius a um (+gen)	begierig nach
incidere incido incidi	hineinfallen, in etw. geraten
id est	das heisst, das bedeutet
res familiaris	Vermögen, Besitz
satis otii	genug Musse
parum otii	zu wenig Musse
dignus cognitione	wert...es kennenzulernen
